"","PatientID","StartTime","EndTime","Duration","BestResponse","Age","Gender","ECOG_PS","PriorTherapy"
"1","PT001",0,36,36,"CR",73,"F",1,"Yes"
"14","PT014",0,24,24,"PR",74,"F",0,"No"
"10","PT010",0,23,23,"CR",41,"M",0,"Yes"
"21","PT021",2,25,23,"PD",42,"F",2,"No"
"6","PT006",0,22,22,"PR",46,"F",1,"Yes"
"11","PT011",0,22,22,"PR",47,"F",0,"Yes"
"22","PT022",5,27,22,"PR",68,"M",0,"Yes"
"24","PT024",5,25,20,"PR",68,"M",0,"Yes"
"27","PT027",4,23,19,"CR",74,"M",1,"Yes"
"12","PT012",0,18,18,"SD",68,"M",0,"Yes"
"16","PT016",0,18,18,"PR",57,"M",0,"Yes"
"23","PT023",3,21,18,"SD",52,"M",0,"No"
"3","PT003",0,17,17,NA,71,"M",1,"Yes"
"15","PT015",0,17,17,"SD",40,"F",2,"Yes"
"13","PT013",0,16,16,"PD",56,"M",0,"No"
"4","PT004",0,15,15,"SD",35,"F",1,"Yes"
"18","PT018",0,15,15,"PD",80,"F",0,"Yes"
"17","PT017",0,14,14,"PR",84,"M",0,"Yes"
"26","PT026",1,14,13,"SD",44,"F",0,"Yes"
"9","PT009",0,10,10,"PR",53,"M",2,"Yes"
"29","PT029",4,14,10,"PD",58,"M",0,"No"
"19","PT019",0,9,9,"CR",79,"F",0,"No"
"7","PT007",0,8,8,"PR",54,"F",2,"No"
"28","PT028",5,13,8,"CR",40,"M",0,"Yes"
"30","PT030",3,11,8,"SD",61,"F",0,"No"
"20","PT020",0,6,6,"SD",44,"M",1,"Yes"
"5","PT005",0,5,5,"PR",59,"M",1,"Yes"
"8","PT008",0,4,4,"SD",66,"F",1,"Yes"
"25","PT025",6,10,4,"CR",51,"M",0,"Yes"
"2","PT002",0,2,2,"PD",66,"M",2,"Yes"
